100011100000000000000000000000
100011100000000000000000000000
100011101111100000000000000000
111111101111100000000000000000
111111161131100000000000000000
111111101111100000000000000000
000011101111100000000000000000
000011100000000000000000000000
000011100000000000000000000000
000004000000000000000000000000
000011100000000000000000000000
000011100000000000000000000000
000011111100000000000000000000
000011111200000000000000000000
000011111100000000000000000000
000000000000000000000000000000
000000000000000000000000000000
000000000000000000000000000000
000000000000000000000000000000
000000000000000000000000000000
000000000000000000000000000000
000000000000000000000000000000
000000000000000000000000000000
000000000000000000000000000000
000000000000000000000000000000
000000000000000000000000000000
000000000000000000000000000000
000000000000000000000000000000
000000000000000000000000000000
000000000000000000000000000000
