110011111113000000000000000000
110011111111000000000000000000
110011000000000000110000000000
110011000000000000110000000000
116111141110031000110000000000
116111141110011000110000000000
000000000770011114110000000000
000000000110011114130000000000
000000000110066000000000000000
001111111111111000000000000000
001111111111114111111111111300
004400000000014111111111111100
001100111111111000110000000000
001100111111113000770000000000
001100110000000000110000000000
001100110000000000110000000000
001100110000000000110000000000
001100110000000000110000000000
001111116111111111111111111100
003111116111111111111111111100
000000000000000000440000000000
000000000000000000110000000000
000000000000000000110000000000
000000000000000000110000011112
000000000000000000110000011112
000000000000000000111117111112
000000000000000000111117111112
000000000000000000000000011112
000000000000000000000000011112
000000000000000000000000000000