111171110000000000000000000000
111171110000000000000000000000
111171110000000000000000000000
000011111111111100000000000000
000111111113111100000000000000
000111111111111100000000000000
000000001111111100000000000000
000000001111111100000000000000
000000001111111100000000000000
000000001111111111111111111000
000000001111111111111111111000
000000111111116666611111111000
000111111111116111611111111000
000111111111116111611111111000
000111111111116111611111111000
000000000000000141000000000000
000000000000000020000000000000
000000000000000111000000000000
000000000000000000000000000000
000000000000000000000000000000
000000000000000000000000000000
000000000000000000000000000000
000000000000000000000000000000
000000000000000000000000000000
000000000000000000000000000000
000000000000000000000000000000
000000000000000000000000000000
000000000000000000000000000000
000000000000000000000000000000
000000000000000000000000000000