10000000000000000000
10011100011113000000
10010101110000000000
10010111010000000000
11110000011000000000
00000000001100000012
00000000000100000110
00000000000111000100
00000000000001141100
00000000000000000000
00000000000000000000
00000000000000000000
00000000000000000000
00000000000000000000
00000000000000000000
00000000000000000000
00000000000000000000
00000000000000000000
00000000000000000000
00000000000000000000
