111111110000000000000000000000
111111110000000000000000000000
111111110000000000000000000000
000011111111111101111111111000
000111111111111101111111111000
000111111111111101111131111000
000111111111111101111111111000
000111111111111101111111111000
000111111111111100000004000000
000111111111111111111111111000
000111111111111111111111111000
000111111111111111111111111000
000111171111111111111111111000
000111111111111111111111111000
000111111111111111111111111000
000000000000000141000000000000
000000000000000020000000000000
000000000000000111000000000000
000000000000000000000000000000
000000000000000000000000000000
000000000000000000000000000000
000000000000000000000000000000
000000000000000000000000000000
000000000000000000000000000000
000000000000000000000000000000
000000000000000000000000000000
000000000000000000000000000000
000000000000000000000000000000
000000000000000000000000000000
000000000000000000000000000000