111111000000000000000000000000
111111000000000000000000000000
001111000000111100000000000000
001111000000111100000000000000
001111111111111111000000001100
001111111111111113000000001100
001111000000111100000000001100
001111000000111100000000001100
000000000000111100001111111100
000000000000444400001131111100
000000000000011000000000001100
000000000000011000000000001100
001111111111111000000000001100
001111111111111000000000001100
001100000000000000000000001100
001100000000000000000000001100
001100000000000000000000001100
001100000000000000000000001100
001111111111111111111111111100
001111111111111111111111111100
000000000011110000000000000000
000000000044440000000000000000
000000000011110000000000000000
000000000011110000000000000000
000000000011110000000000000000
000000000002000000000000000000
000000000000000000000000000000
000000000000000000000000000000
000000000000000000000000000000
000000000000000000000000000000