111110000000000000000000000000
111110000000000000000000000000
011111000000000000000000000000
011111111111111111111111100000
000111110000000000000111100000
000111110000000000000111100000
000011111000000000000111300000
000011111000000000000111100000
000111111100000000000111100000
000111111100000000000111100000
000000011130000000000111100000
000000011110000000000111100000
000000004000000000000111100000
011111111000000000000111100000
000001111111111111000111100000
000001111111111111000111100000
000000000111110000000111100000
000000000111110000000111100000
000000000111110000000004000000
000000000001111111111111100000
000000000001111111100113100000
000000000001111111100111100000
000000000001111111111111100000
000000000000400000000000000000
000000001111100000000000000000
000000002000000000000000000000
000000000000000000000000000000
000000000000000000000000000000
000000000000000000000000000000
000000000000000000000000000000