111000000000000000000000000000
111000000000000000000000000000
111111111111111100000000000000
111111111111111100000000000000
111111111111111100000000000000
111111111111111100000000000000
111111111111111100000000000000
111111111111111100000000000000
111111111111111100000000000000
111111111111111100000000000000
111111111111111100000000000000
111111111111111100000000000000
111111111111111100000000000000
111111111111111100000000000000
000011100000000000000000000000
000011111111111100000000000000
000011111111111100000000000000
000011111111111100000000000000
000011111111111100000000000000
000011111111111100000000000000
000011111111111100000000000000
000011100000000000000000000000
000011000000000000000000000000
000011000000000000000000000000
000011111100000000000000000000
000011111111100000000000000000
000000011111100000000000000000
000000000011100000000000000000
000000000000000000000000000000
000000000000000000000000000000
