111111110000000000000000000000
111111110000000000000000000000
111111110000000000000000000000
000111110000000000000000000000
000111111111111000000000000000
000111111111111000000000000000
000111111111111000000000000000
000111111111111000000000000000
000000000016100000000000000000
000000000011100000000000000000
000000000011100000000000000000
000111111111111111110000000000
000113111111111111110000000000
000111111111111111110000000000
000000000111411100000000000000
000000000111211100000000000000
000000000011111000000000000000
000000000000000000000000000000
000000000000000000000000000000
000000000000000000000000000000
000000000000000000000000000000
000000000000000000000000000000
000000000000000000000000000000
000000000000000000000000000000
000000000000000000000000000000
000000000000000000000000000000
000000000000000000000000000000
000000000000000000000000000000
000000000000000000000000000000
000000000000000000000000000000