11000000011100000000
11100001111100000000
01111111100000000000
00111100000000000000
00000100000000001100
00000100000000001100
00000110000000011000
00000011100000111000
00000000100001111000
00000000111111110000
00000000011110000000
11000000000100000000
11100000000100000000
01110000000100000000
00111000000100000000
00001110001100000000
00000111111000000000
00000001110000000000
00000000000000000000
00000000000000000000
