100011100000000000000000000000
100011100000000000000000000000
100011101771300000000000000000
111111107111100000000000000000
111111117111700000001111111000
111111107111700000077711111000
000011101777700000111100111000
000011100000000001111000111000
000011100000000011110000311000
000004000000000666600000111000
000011111111111111000000444000
000011100000000000000000111000
000000000000000000000000111000
000011111200000000111111111000
000011111100111100111100000000
000111100000101100111100000000
000111100000300111110000000000
000111100000000001111000000000
000111100000000111100000000000
000011111116111111100000000000
000000000000000000000000000000
000000000000000000000000000000
000000000000000000000000000000
000000000000000000000000000000
000000000000000000000000000000
000000000000000000000000000000
000000000000000000000000000000
000000000000000000000000000000
000000000000000000000000000000
000000000000000000000000000000
