111111110000000000000000000000
111111110000000000000000000000
111111110000000000000000000000
000676760000000000000000000000
000111111111111000000000000000
000111111111111000000000000000
000111111111111000000000000000
000111111111111000000000000000
000000000006000000000000000000
000000000001000000000000000000
000000000001000000000000000000
000111111111111111110000000000
000113111111111111110000000000
000111111111111111110000000000
000000000000400000000000000000
000000000111111100000000000000
000000000011211000000000000000
000000000000000000000000000000
000000000000000000000000000000
000000000000000000000000000000
000000000000000000000000000000
000000000000000000000000000000
000000000000000000000000000000
000000000000000000000000000000
000000000000000000000000000000
000000000000000000000000000000
000000000000000000000000000000
000000000000000000000000000000
000000000000000000000000000000
000000000000000000000000000000