110011101110111000000000000000
110010111011103000000000000000
110011000000000000110000000000
110011000000000000110000000000
116111141110031000110000000000
116111141110011000110000000000
000000000770011114110000000000
000000000110011114130000000000
000000000110066000000000000000
001611711111111000000000000000
001711611111111411111111111300
004400000000011411111111111100
001100311111111000110000000000
000100111111111000770000000000
001100110000000000110000000000
001000610000000000110000000000
001100110000000000110000000000
000100170000000000110000000000
001111116111117117117111171100
003111116111611161111611111160
000000000000000000440000000000
000000000000000000710000000000
000000000000000000110000000000
000000000000000000160000011110
000000000000000000110000011110
000000000000000000716117111110
000000000000000000116117111110
000000000000000000000000012110
000000000000000000000000000000
000000000000000000000000000000