111111000000000000000000000000
111111000000111111111111111130
001116000000111100000000000000
001171000000111100000000000000
001611111116111111000000001100
007676761117111111130000001100
001611000000111100000000001100
001171000000444400000000001100
000000000000111100001111111100
000000000000044000001131117100
000000000000011000000000001100
000000000000011000000000001600
001111111111111000000000001100
001111111111111000000000007100
001100000000000000000000001100
001100000000000000000000001600
001100000000000000000000001100
001100000000000000000000007100
001161111171111111711111111100
001171111161111111711111111600
000000000061160000000000000000
000000000044440000000000000000
000000000011110000000000000000
000000000077770000000000000000
000000000011111000000000000000
000000000001110000000000000000
000000000000200000000000000000
000000000000000000000000000000
000000000000000000000000000000
000000000000000000000000000000