111171110000000000000000000000
111171110000000000000000000000
111171110000000000000000000000
000001111111111100000000000000
000001111113111100000000000000
000001111111111100000000000000
000000001111111100000000000000
000000001111111100000000000000
000000001111111100000000000000
000000001111111111111111111000
000000001111111111111111111000
000000111111116777611111111000
000111111111117111711111111000
000111111111117111711111111000
000111111111116111611111111000
000000000000000040000000000000
000000000000000010000000000000
000000000000000121000000000000
000000000000000000000000000000
000000000000000000000000000000
000000000000000000000000000000
000000000000000000000000000000
000000000000000000000000000000
000000000000000000000000000000
000000000000000000000000000000
000000000000000000000000000000
000000000000000000000000000000
000000000000000000000000000000
000000000000000000000000000000
000000000000000000000000000000